Name,Math,Science,English,Total,Grade
Alice,89,94,88,271,A
Bob,75,70,68,213,B
Charlie,95,92,90,277,A
David,65,60,58,183,C
Eva,78,85,80,243,B
Frank,55,59,54,168,D
Grace,88,84,82,254,A
Hannah,72,75,74,221,B
Ian,90,91,89,270,A
Julia,60,62,65,187,C
Kevin,80,77,79,236,B
Lily,98,96,97,291,A
Mike,45,50,48,143,D
Nina,83,86,81,250,A
Oscar,66,70,72,208,C
